40
0 -1 50 43 0 0 117 43 0 0 0 0 0 0 0 0 4
1 -1 50 43 0 0 191 86 0 0 0 0 0 0 0 0 4
2 -1 50 43 0 0 266 43 0 0 0 0 0 0 0 0 4
3 5 50 43 0 0 340 86 0 0 0 0 0 0 0 0 4
4 5 50 43 0 0 414 43 0 0 0 0 0 0 0 0 4
5 -1 50 43 0 0 488 86 0 0 0 0 0 0 0 0 4
6 -1 50 43 0 0 563 43 0 0 0 0 0 0 0 0 4
7 -1 50 43 0 0 637 86 0 0 0 0 0 0 0 0 4
8 -1 50 43 0 0 117 130 0 0 0 0 0 0 0 0 4
9 -1 50 43 0 0 191 173 0 0 0 0 0 0 0 0 4
10 -1 50 43 0 0 266 130 0 0 0 0 0 0 0 0 4
11 5 50 43 0 0 340 173 0 0 0 0 0 0 0 0 4
12 5 50 43 0 0 414 130 0 0 0 0 0 0 0 0 4
13 4 50 43 0 0 488 173 0 0 0 0 0 0 0 0 4
14 -1 50 43 0 0 563 130 0 0 0 0 0 0 0 0 4
15 -1 50 43 0 0 637 173 0 0 0 0 0 0 0 0 4
16 -1 50 43 0 0 117 216 0 0 0 0 0 0 0 0 4
17 3 50 43 0 0 191 260 0 0 0 0 0 0 3 0 0
18 4 50 43 0 0 266 216 0 0 0 1 0 0 0 0 4
19 5 50 43 0 0 340 260 0 0 0 0 0 0 0 0 4
20 5 50 43 0 0 414 216 0 0 0 0 0 0 0 0 4
21 4 50 43 0 0 488 260 0 0 0 1 0 0 0 0 4
22 3 50 43 0 0 563 216 0 0 0 0 0 0 3 0 1
23 -1 50 43 0 0 637 260 0 0 0 0 0 0 0 0 4
24 -1 50 43 0 0 117 303 0 0 0 0 0 0 0 0 4
25 -1 50 43 0 0 191 346 0 0 0 0 0 0 0 0 4
26 4 50 43 0 0 266 303 0 0 0 0 0 0 0 0 4
27 5 50 43 0 0 340 346 0 0 0 0 0 0 0 0 4
28 5 50 43 0 0 414 303 0 0 0 0 0 0 0 0 4
29 -1 50 43 0 0 488 346 0 0 0 0 0 0 0 0 4
30 -1 50 43 0 0 563 303 0 0 0 0 0 0 0 0 4
31 -1 50 43 0 0 637 346 0 0 0 0 0 0 0 0 4
32 -1 50 43 0 0 117 389 0 0 0 0 0 0 0 0 4
33 -1 50 43 0 0 191 433 0 0 0 0 0 0 0 0 4
34 -1 50 43 0 0 266 389 0 0 0 0 0 0 0 0 4
35 5 50 43 0 0 340 433 0 0 0 0 0 0 0 0 4
36 5 50 43 0 0 414 389 0 0 0 0 0 0 0 0 4
37 -1 50 43 0 0 488 433 0 0 0 0 0 0 0 0 4
38 -1 50 43 0 0 563 389 0 0 0 0 0 0 0 0 4
39 -1 50 43 0 0 637 433 0 0 0 0 0 0 0 0 4
