77
0 -1 50 43 0 0 117 43 0 0 0 0 0 0 0 0 4
1 4 50 43 0 0 191 86 0 0 0 0 0 0 0 0 0
2 -1 50 43 0 0 266 43 0 0 0 0 0 0 0 0 4
3 -1 50 43 0 0 340 86 0 0 0 0 0 0 0 0 4
4 -1 50 43 0 0 414 43 0 0 0 0 0 0 0 0 4
5 -1 50 43 0 0 488 86 0 0 0 0 0 0 0 0 4
6 -1 50 43 0 0 563 43 0 0 0 0 0 0 0 0 4
7 -1 50 43 0 0 637 86 0 0 0 0 0 0 0 0 4
8 -1 50 43 0 0 711 43 0 0 0 0 0 0 0 0 4
9 4 50 43 0 0 785 86 0 0 0 0 0 0 0 0 1
10 -1 50 43 0 0 860 43 0 0 0 0 0 0 0 0 4
11 -1 50 43 0 0 117 130 0 0 0 0 0 0 0 0 4
12 -1 50 43 0 0 191 173 0 0 0 0 0 0 0 0 4
13 5 50 43 0 0 266 130 0 0 0 0 0 0 3 0 0
14 6 50 43 0 0 340 173 0 0 0 0 0 0 0 0 4
15 -1 50 43 0 0 414 130 0 0 0 0 0 0 0 0 4
16 7 50 43 0 0 488 173 0 0 0 0 0 0 0 0 4
17 -1 50 43 0 0 563 130 0 0 0 0 0 0 0 0 4
18 6 50 43 0 0 637 173 0 0 0 0 0 0 0 0 4
19 5 50 43 0 0 711 130 0 0 0 0 0 0 3 0 1
20 -1 50 43 0 0 785 173 0 0 0 0 0 0 0 0 4
21 -1 50 43 0 0 860 130 0 0 0 0 0 0 0 0 4
22 -1 50 43 0 0 117 216 0 0 0 0 0 0 0 0 4
23 -1 50 43 0 0 191 260 0 0 0 0 0 0 0 0 4
24 -1 50 43 0 0 266 216 0 0 0 0 0 0 0 0 4
25 -1 50 43 0 0 340 260 0 0 0 0 0 0 0 0 4
26 7 50 43 0 0 414 216 0 0 0 0 0 0 0 0 4
27 8 50 43 0 0 488 260 0 0 0 0 0 0 0 0 4
28 7 50 43 0 0 563 216 0 0 0 0 0 0 0 0 4
29 -1 50 43 0 0 637 260 0 0 0 0 0 0 0 0 4
30 -1 50 43 0 0 711 216 0 0 0 0 0 0 0 0 4
31 -1 50 43 0 0 785 260 0 0 0 0 0 0 0 0 4
32 -1 50 43 0 0 860 216 0 0 0 0 0 0 0 0 4
33 -1 50 43 0 0 117 303 0 0 0 0 0 0 0 0 4
34 -1 50 43 0 0 191 346 0 0 0 0 0 0 0 0 4
35 -1 50 43 0 0 266 303 0 0 0 0 0 0 0 0 4
36 -1 50 43 0 0 340 346 0 0 0 0 0 0 0 0 4
37 7 50 43 0 0 414 303 0 0 0 0 0 0 0 0 4
38 7 50 43 0 0 488 346 0 0 0 0 0 0 0 0 4
39 7 50 43 0 0 563 303 0 0 0 0 0 0 0 0 4
40 -1 50 43 0 0 637 346 0 0 0 0 0 0 0 0 4
41 -1 50 43 0 0 711 303 0 0 0 0 0 0 0 0 4
42 -1 50 43 0 0 785 346 0 0 0 0 0 0 0 0 4
43 -1 50 43 0 0 860 303 0 0 0 0 0 0 0 0 4
44 -1 50 43 0 0 117 389 0 0 0 0 0 0 0 0 4
45 -1 50 43 0 0 191 433 0 0 0 0 0 0 0 0 4
46 -1 50 43 0 0 266 389 0 0 0 0 0 0 0 0 4
47 -1 50 43 0 0 340 433 0 0 0 0 0 0 0 0 4
48 -1 50 43 0 0 414 389 0 0 0 0 0 0 0 0 4
49 6 50 43 0 0 488 433 0 0 0 0 0 0 0 0 4
50 -1 50 43 0 0 563 389 0 0 0 0 0 0 0 0 4
51 -1 50 43 0 0 637 433 0 0 0 0 0 0 0 0 4
52 -1 50 43 0 0 711 389 0 0 0 0 0 0 0 0 4
53 -1 50 43 0 0 785 433 0 0 0 0 0 0 0 0 4
54 -1 50 43 0 0 860 389 0 0 0 0 0 0 0 0 4
55 -1 50 43 0 0 117 476 0 0 0 0 0 0 0 0 4
56 -1 50 43 0 0 191 519 0 0 0 0 0 0 0 0 4
57 -1 50 43 0 0 266 476 0 0 0 0 0 0 0 0 4
58 -1 50 43 0 0 340 519 0 0 0 0 0 0 0 0 4
59 -1 50 43 0 0 414 476 0 0 0 0 0 0 0 0 4
60 5 50 43 0 0 488 519 0 0 0 0 0 0 0 0 4
61 -1 50 43 0 0 563 476 0 0 0 0 0 0 0 0 4
62 -1 50 43 0 0 637 519 0 0 0 0 0 0 0 0 4
63 -1 50 43 0 0 711 476 0 0 0 0 0 0 0 0 4
64 -1 50 43 0 0 785 519 0 0 0 0 0 0 0 0 4
65 -1 50 43 0 0 860 476 0 0 0 0 0 0 0 0 4
66 -1 50 43 0 0 117 563 0 0 0 0 0 0 0 0 4
67 -1 50 43 0 0 191 606 0 0 0 0 0 0 0 0 4
68 -1 50 43 0 0 266 563 0 0 0 0 0 0 0 0 4
69 -1 50 43 0 0 340 606 0 0 0 0 0 0 0 0 4
70 -1 50 43 0 0 414 563 0 0 0 0 0 0 0 0 4
71 4 50 43 0 0 488 606 0 0 0 0 0 0 0 0 4
72 -1 50 43 0 0 563 563 0 0 0 0 0 0 0 0 4
73 -1 50 43 0 0 637 606 0 0 0 0 0 0 0 0 4
74 -1 50 43 0 0 711 563 0 0 0 0 0 0 0 0 4
75 -1 50 43 0 0 785 606 0 0 0 0 0 0 0 0 4
76 -1 50 43 0 0 860 563 0 0 0 0 0 0 0 0 4
